player,6,5
levelblock,mainmenu.txt
levelblock,mainmenu.txt
start
############
#.YOU.DIED.#
#..........#
#..........#
#..........#
#..#....#..#
#..######..#
#..........#
#..........#
#MENU.RETRY#
#1........0#
############