player,2,2
levelblock,mainmenu.txt
start
##################
#...............<#
########^^^^^##.##
       ########.#
              #.#
              #.#
              #.#
              #.##
              #.<######
              #......0#
              #^#######
              ###