player,6,4
levelblock,levelone_4.txt
start
############
#..........#
#..........####
#..........vvv#
#.............#
#..........@.<#
############.<#
#>...........<#
#>............#
#>.........^^^#
#..........####
#0....^^^^^#
############
