player,1,1
levelblock,mainmenu.txt
start
################
#..............#
#######...######
#.v...#...#....#
#.....#........#
#..#...^^^.....#
#..#..<###>....#
#..#..<#0#>.####
#..#..#v.v.....#
#..#..#..#.....#
#..#..#.##.....#
#..#..#..#.....#
#..#..#..#.....#
#..#.....#.....#
##.########.####
 #..........#
 ############
