player,6,4
levelblock,levelone_2.txt
start
############
#..........#
#..........####
#..........vvv#
#.............#
#..........@.<#
############.<#
#............<#
#.............#
#..........^^^#
#..........####
#0.........#
############