player,1,4
levelblock,levelone_7.txt
start
############
#..........#
#...#...#..####
#...#...#.....#
#...#...#.....#
#...#^.^#.....#
######.########
#....#.#......#
#....#.#......#
#....#.#......#
#..........####
#0...^^^...#
############
