player,6,4
levelblock,levelone_1.txt
start
############
#..........#
#..........####
#..........vvv#
#.............#
#..........@..#
############..#
#.............#
#.............#
#..........^^^#
#..........####
#0.........#
############